"filename", "language", "C#", "comment", "blank", "total"
"f:\Unity\Marbles Battle Royale (Chenli)\Marbles-Battle-Royale-Online-Game-Development\Marbles Battle Royale (Chenli)\Assets\Scripts\CollisionDetect.cs", "C#", -71, 58, 0, -13
"f:\Unity\Marbles Battle Royale (Chenli)\Marbles-Battle-Royale-Online-Game-Development\Marbles Battle Royale (Chenli)\Assets\Scripts\JumpController.cs", "C#", 9, 4, 1, 14
"f:\Unity\Marbles Battle Royale (Chenli)\Marbles-Battle-Royale-Online-Game-Development\Marbles Battle Royale (Chenli)\Assets\Scripts\Menu Scrips\GuidanceText.cs", "C#", 8, 1, 0, 9
"f:\Unity\Marbles Battle Royale (Chenli)\Marbles-Battle-Royale-Online-Game-Development\Marbles Battle Royale (Chenli)\Assets\Scripts\Menu Scrips\PlayerManager.cs", "C#", 2, 1, -1, 2
"f:\Unity\Marbles Battle Royale (Chenli)\Marbles-Battle-Royale-Online-Game-Development\Marbles Battle Royale (Chenli)\Assets\Scripts\Menu Scrips\SoundController.cs", "C#", 4, 0, 1, 5
"f:\Unity\Marbles Battle Royale (Chenli)\Marbles-Battle-Royale-Online-Game-Development\Marbles Battle Royale (Chenli)\Assets\Scripts\QuickTransfer.cs", "C#", -29, -10, -13, -52
"f:\Unity\Marbles Battle Royale (Chenli)\Marbles-Battle-Royale-Online-Game-Development\Marbles Battle Royale (Chenli)\Assets\Scripts\ToolBox.cs", "C#", 73, 12, 12, 97
"f:\Unity\Marbles Battle Royale (Chenli)\Marbles-Battle-Royale-Online-Game-Development\Marbles Battle Royale (Chenli)\Assets\Scripts\TrainningGroundScrips\RobotBillbord.cs", "C#", 1, -1, 0, 0
"f:\Unity\Marbles Battle Royale (Chenli)\Marbles-Battle-Royale-Online-Game-Development\Marbles Battle Royale (Chenli)\Assets\Scripts\TrainningGroundScrips\RobotController.cs", "C#", 29, 2, 5, 36
"f:\Unity\Marbles Battle Royale (Chenli)\Marbles-Battle-Royale-Online-Game-Development\Marbles Battle Royale (Chenli)\Assets\Scripts\UI Scrips\Billboard.cs", "C#", 17, 1, 3, 21
"Total", "-", 43, 68, 8, 119