"filename", "language", "C#", "comment", "blank", "total"
"f:\Unity\Marbles Battle Royale (Chenli)\Marbles-Battle-Royale-Online-Game-Development\Marbles Battle Royale (Chenli)\Assets\Scripts\ButtonSoundCtrl.cs", "C#", -3, -1, -2, -6
"f:\Unity\Marbles Battle Royale (Chenli)\Marbles-Battle-Royale-Online-Game-Development\Marbles Battle Royale (Chenli)\Assets\Scripts\CameraMove.cs", "C#", -55, -2, -15, -72
"f:\Unity\Marbles Battle Royale (Chenli)\Marbles-Battle-Royale-Online-Game-Development\Marbles Battle Royale (Chenli)\Assets\Scripts\CollisionDetect.cs", "C#", -21, 3, -22, -40
"f:\Unity\Marbles Battle Royale (Chenli)\Marbles-Battle-Royale-Online-Game-Development\Marbles Battle Royale (Chenli)\Assets\Scripts\JumpController.cs", "C#", -1, -8, -4, -13
"f:\Unity\Marbles Battle Royale (Chenli)\Marbles-Battle-Royale-Online-Game-Development\Marbles Battle Royale (Chenli)\Assets\Scripts\Keep.cs", "C#", -26, 17, -2, -11
"f:\Unity\Marbles Battle Royale (Chenli)\Marbles-Battle-Royale-Online-Game-Development\Marbles Battle Royale (Chenli)\Assets\Scripts\LeftandRight.cs", "C#", -6, -8, -9, -23
"f:\Unity\Marbles Battle Royale (Chenli)\Marbles-Battle-Royale-Online-Game-Development\Marbles Battle Royale (Chenli)\Assets\Scripts\Menu Scrips\KeepSetting.cs", "C#", 0, 0, 1, 1
"f:\Unity\Marbles Battle Royale (Chenli)\Marbles-Battle-Royale-Online-Game-Development\Marbles Battle Royale (Chenli)\Assets\Scripts\Menu Scrips\MenuManager.cs", "C#", 13, -20, -9, -16
"f:\Unity\Marbles Battle Royale (Chenli)\Marbles-Battle-Royale-Online-Game-Development\Marbles Battle Royale (Chenli)\Assets\Scripts\Menu Scrips\NetworkManager.cs", "C#", 3, -3, -16, -16
"f:\Unity\Marbles Battle Royale (Chenli)\Marbles-Battle-Royale-Online-Game-Development\Marbles Battle Royale (Chenli)\Assets\Scripts\Menu Scrips\PlayerManager.cs", "C#", 52, -1, -6, 45
"f:\Unity\Marbles Battle Royale (Chenli)\Marbles-Battle-Royale-Online-Game-Development\Marbles Battle Royale (Chenli)\Assets\Scripts\Menu Scrips\RoomManager.cs", "C#", 7, 1, 0, 8
"f:\Unity\Marbles Battle Royale (Chenli)\Marbles-Battle-Royale-Online-Game-Development\Marbles Battle Royale (Chenli)\Assets\Scripts\Menu Scrips\SoundController.cs", "C#", -4, 0, 0, -4
"f:\Unity\Marbles Battle Royale (Chenli)\Marbles-Battle-Royale-Online-Game-Development\Marbles Battle Royale (Chenli)\Assets\Scripts\MovementController.cs", "C#", -77, 11, -13, -79
"f:\Unity\Marbles Battle Royale (Chenli)\Marbles-Battle-Royale-Online-Game-Development\Marbles Battle Royale (Chenli)\Assets\Scripts\RotateAndShake.cs", "C#", 0, 0, 1, 1
"f:\Unity\Marbles Battle Royale (Chenli)\Marbles-Battle-Royale-Online-Game-Development\Marbles Battle Royale (Chenli)\Assets\Scripts\SpectatorMovement.cs", "C#", 1, 0, -1, 0
"f:\Unity\Marbles Battle Royale (Chenli)\Marbles-Battle-Royale-Online-Game-Development\Marbles Battle Royale (Chenli)\Assets\Scripts\ToolBox.cs", "C#", 0, 3, 1, 4
"f:\Unity\Marbles Battle Royale (Chenli)\Marbles-Battle-Royale-Online-Game-Development\Marbles Battle Royale (Chenli)\Assets\Scripts\TouchUp.cs", "C#", 1, -11, 0, -10
"f:\Unity\Marbles Battle Royale (Chenli)\Marbles-Battle-Royale-Online-Game-Development\Marbles Battle Royale (Chenli)\Assets\Scripts\TrainningGroundScrips\RobotController.cs", "C#", -3, 4, 1, 2
"f:\Unity\Marbles Battle Royale (Chenli)\Marbles-Battle-Royale-Online-Game-Development\Marbles Battle Royale (Chenli)\Assets\Scripts\UI Scrips\GameInfoManager.cs", "C#", 23, -12, 1, 12
"f:\Unity\Marbles Battle Royale (Chenli)\Marbles-Battle-Royale-Online-Game-Development\Marbles Battle Royale (Chenli)\Assets\Scripts\UI Scrips\GameSetting.cs", "C#", 24, 1, 4, 29
"f:\Unity\Marbles Battle Royale (Chenli)\Marbles-Battle-Royale-Online-Game-Development\Marbles Battle Royale (Chenli)\Assets\Scripts\UI Scrips\InGameUIManager.cs", "C#", -1, 1, 0, 0
"f:\Unity\Marbles Battle Royale (Chenli)\Marbles-Battle-Royale-Online-Game-Development\Marbles Battle Royale (Chenli)\Assets\Scripts\UI Scrips\ScoreBoardManager.cs", "C#", 0, -3, 0, -3
"f:\Unity\Marbles Battle Royale (Chenli)\Marbles-Battle-Royale-Online-Game-Development\Marbles Battle Royale (Chenli)\Assets\Scripts\WallFoward.cs", "C#", 2, -1, -1, 0
"f:\Unity\Marbles Battle Royale (Chenli)\Marbles-Battle-Royale-Online-Game-Development\Marbles Battle Royale (Chenli)\Assets\Scripts\maincamera.cs", "C#", -124, -13, -24, -161
"Total", "-", -195, -42, -115, -352