"filename", "language", "C#", "JSON", "comment", "blank", "total"
"f:\Unity\Marbles Battle Royale (Chenli)\Marbles-Battle-Royale-Online-Game-Development\Marbles Battle Royale (Chenli)\Assets\Scripts\.vs\ProjectSettings.json", "JSON", 0, 3, 0, 0, 3
"f:\Unity\Marbles Battle Royale (Chenli)\Marbles-Battle-Royale-Online-Game-Development\Marbles Battle Royale (Chenli)\Assets\Scripts\.vs\VSWorkspaceState.json", "JSON", 0, 7, 0, 0, 7
"f:\Unity\Marbles Battle Royale (Chenli)\Marbles-Battle-Royale-Online-Game-Development\Marbles Battle Royale (Chenli)\Assets\Scripts\AnimateLoading.cs", "C#", 21, 0, 8, 5, 34
"f:\Unity\Marbles Battle Royale (Chenli)\Marbles-Battle-Royale-Online-Game-Development\Marbles Battle Royale (Chenli)\Assets\Scripts\ButtonSoundCtrl.cs", "C#", 13, 0, 1, 2, 16
"f:\Unity\Marbles Battle Royale (Chenli)\Marbles-Battle-Royale-Online-Game-Development\Marbles Battle Royale (Chenli)\Assets\Scripts\CollisionDetect.cs", "C#", 147, 0, 121, 35, 303
"f:\Unity\Marbles Battle Royale (Chenli)\Marbles-Battle-Royale-Online-Game-Development\Marbles Battle Royale (Chenli)\Assets\Scripts\CollisionTrigger.cs", "C#", 36, 0, 41, 17, 94
"f:\Unity\Marbles Battle Royale (Chenli)\Marbles-Battle-Royale-Online-Game-Development\Marbles Battle Royale (Chenli)\Assets\Scripts\JumpController.cs", "C#", 215, 0, 45, 30, 290
"f:\Unity\Marbles Battle Royale (Chenli)\Marbles-Battle-Royale-Online-Game-Development\Marbles Battle Royale (Chenli)\Assets\Scripts\JumpPad.cs", "C#", 21, 0, 0, 3, 24
"f:\Unity\Marbles Battle Royale (Chenli)\Marbles-Battle-Royale-Online-Game-Development\Marbles Battle Royale (Chenli)\Assets\Scripts\LeftandRight.cs", "C#", 47, 0, 7, 6, 60
"f:\Unity\Marbles Battle Royale (Chenli)\Marbles-Battle-Royale-Online-Game-Development\Marbles Battle Royale (Chenli)\Assets\Scripts\Menu Scrips\KeepSetting.cs", "C#", 30, 0, 16, 7, 53
"f:\Unity\Marbles Battle Royale (Chenli)\Marbles-Battle-Royale-Online-Game-Development\Marbles Battle Royale (Chenli)\Assets\Scripts\Menu Scrips\Menu.cs", "C#", 24, 0, 1, 7, 32
"f:\Unity\Marbles Battle Royale (Chenli)\Marbles-Battle-Royale-Online-Game-Development\Marbles Battle Royale (Chenli)\Assets\Scripts\Menu Scrips\MenuManager.cs", "C#", 122, 0, 5, 9, 136
"f:\Unity\Marbles Battle Royale (Chenli)\Marbles-Battle-Royale-Online-Game-Development\Marbles Battle Royale (Chenli)\Assets\Scripts\Menu Scrips\NetworkManager.cs", "C#", 304, 0, 38, 32, 374
"f:\Unity\Marbles Battle Royale (Chenli)\Marbles-Battle-Royale-Online-Game-Development\Marbles Battle Royale (Chenli)\Assets\Scripts\Menu Scrips\PlayerListItem.cs", "C#", 24, 0, 4, 6, 34
"f:\Unity\Marbles Battle Royale (Chenli)\Marbles-Battle-Royale-Online-Game-Development\Marbles Battle Royale (Chenli)\Assets\Scripts\Menu Scrips\PlayerManager.cs", "C#", 353, 0, 62, 47, 462
"f:\Unity\Marbles Battle Royale (Chenli)\Marbles-Battle-Royale-Online-Game-Development\Marbles Battle Royale (Chenli)\Assets\Scripts\Menu Scrips\RoomListItem.cs", "C#", 19, 0, 0, 3, 22
"f:\Unity\Marbles Battle Royale (Chenli)\Marbles-Battle-Royale-Online-Game-Development\Marbles Battle Royale (Chenli)\Assets\Scripts\Menu Scrips\RoomManager.cs", "C#", 63, 0, 13, 9, 85
"f:\Unity\Marbles Battle Royale (Chenli)\Marbles-Battle-Royale-Online-Game-Development\Marbles Battle Royale (Chenli)\Assets\Scripts\Menu Scrips\SoundController.cs", "C#", 94, 0, 9, 19, 122
"f:\Unity\Marbles Battle Royale (Chenli)\Marbles-Battle-Royale-Online-Game-Development\Marbles Battle Royale (Chenli)\Assets\Scripts\MovementController.cs", "C#", 67, 0, 16, 16, 99
"f:\Unity\Marbles Battle Royale (Chenli)\Marbles-Battle-Royale-Online-Game-Development\Marbles Battle Royale (Chenli)\Assets\Scripts\ParticleFollow.cs", "C#", 42, 0, 20, 9, 71
"f:\Unity\Marbles Battle Royale (Chenli)\Marbles-Battle-Royale-Online-Game-Development\Marbles Battle Royale (Chenli)\Assets\Scripts\RotateAndShake.cs", "C#", 66, 0, 4, 17, 87
"f:\Unity\Marbles Battle Royale (Chenli)\Marbles-Battle-Royale-Online-Game-Development\Marbles Battle Royale (Chenli)\Assets\Scripts\SpectatorMovement.cs", "C#", 131, 0, 9, 15, 155
"f:\Unity\Marbles Battle Royale (Chenli)\Marbles-Battle-Royale-Online-Game-Development\Marbles Battle Royale (Chenli)\Assets\Scripts\ToolBox.cs", "C#", 78, 0, 16, 14, 108
"f:\Unity\Marbles Battle Royale (Chenli)\Marbles-Battle-Royale-Online-Game-Development\Marbles Battle Royale (Chenli)\Assets\Scripts\TouchUp.cs", "C#", 45, 0, 19, 15, 79
"f:\Unity\Marbles Battle Royale (Chenli)\Marbles-Battle-Royale-Online-Game-Development\Marbles Battle Royale (Chenli)\Assets\Scripts\TrainningGroundScrips\LookAtCamera.cs", "C#", 15, 0, 2, 4, 21
"f:\Unity\Marbles Battle Royale (Chenli)\Marbles-Battle-Royale-Online-Game-Development\Marbles Battle Royale (Chenli)\Assets\Scripts\TrainningGroundScrips\RobotBillbord.cs", "C#", 18, 0, 7, 3, 28
"f:\Unity\Marbles Battle Royale (Chenli)\Marbles-Battle-Royale-Online-Game-Development\Marbles Battle Royale (Chenli)\Assets\Scripts\TrainningGroundScrips\RobotController.cs", "C#", 213, 0, 46, 21, 280
"f:\Unity\Marbles Battle Royale (Chenli)\Marbles-Battle-Royale-Online-Game-Development\Marbles Battle Royale (Chenli)\Assets\Scripts\TrainningGroundScrips\TranningGroundObjects.cs", "C#", 19, 0, 3, 4, 26
"f:\Unity\Marbles Battle Royale (Chenli)\Marbles-Battle-Royale-Online-Game-Development\Marbles Battle Royale (Chenli)\Assets\Scripts\UI Scrips\Billboard.cs", "C#", 40, 0, 24, 8, 72
"f:\Unity\Marbles Battle Royale (Chenli)\Marbles-Battle-Royale-Online-Game-Development\Marbles Battle Royale (Chenli)\Assets\Scripts\UI Scrips\GameInfoItem.cs", "C#", 32, 0, 1, 3, 36
"f:\Unity\Marbles Battle Royale (Chenli)\Marbles-Battle-Royale-Online-Game-Development\Marbles Battle Royale (Chenli)\Assets\Scripts\UI Scrips\GameInfoManager.cs", "C#", 62, 0, 5, 8, 75
"f:\Unity\Marbles Battle Royale (Chenli)\Marbles-Battle-Royale-Online-Game-Development\Marbles Battle Royale (Chenli)\Assets\Scripts\UI Scrips\GameSetting.cs", "C#", 46, 0, 4, 7, 57
"f:\Unity\Marbles Battle Royale (Chenli)\Marbles-Battle-Royale-Online-Game-Development\Marbles Battle Royale (Chenli)\Assets\Scripts\UI Scrips\GuidanceText.cs", "C#", 139, 0, 32, 36, 207
"f:\Unity\Marbles Battle Royale (Chenli)\Marbles-Battle-Royale-Online-Game-Development\Marbles Battle Royale (Chenli)\Assets\Scripts\UI Scrips\InGameUIManager.cs", "C#", 155, 0, 20, 23, 198
"f:\Unity\Marbles Battle Royale (Chenli)\Marbles-Battle-Royale-Online-Game-Development\Marbles Battle Royale (Chenli)\Assets\Scripts\UI Scrips\ScoreBoard.cs", "C#", 66, 0, 3, 8, 77
"f:\Unity\Marbles Battle Royale (Chenli)\Marbles-Battle-Royale-Online-Game-Development\Marbles Battle Royale (Chenli)\Assets\Scripts\UI Scrips\ScoreBoardManager.cs", "C#", 68, 0, 42, 11, 121
"f:\Unity\Marbles Battle Royale (Chenli)\Marbles-Battle-Royale-Online-Game-Development\Marbles Battle Royale (Chenli)\Assets\Scripts\WallFoward.cs", "C#", 26, 0, 0, 4, 30
"f:\Unity\Marbles Battle Royale (Chenli)\Marbles-Battle-Royale-Online-Game-Development\Marbles Battle Royale (Chenli)\Assets\Scripts\cameraDist.cs", "C#", 79, 0, 14, 10, 103
"f:\Unity\Marbles Battle Royale (Chenli)\Marbles-Battle-Royale-Online-Game-Development\Marbles Battle Royale (Chenli)\Assets\Scripts\getspeed.cs", "C#", 23, 0, 4, 7, 34
"Total", "-", 2963, 10, 662, 480, 4115