"filename", "language", "XML", "C#", "comment", "blank", "total"
"f:\Unity\Marbles Battle Royale (Chenli)\Marbles-Battle-Royale-Online-Game-Development\Marbles Battle Royale (Chenli)\Assets\Photon\PhotonChat\Code\ChannelCreationOptions.cs", "C#", 0, 12, 8, 3, 23
"f:\Unity\Marbles Battle Royale (Chenli)\Marbles-Battle-Royale-Online-Game-Development\Marbles Battle Royale (Chenli)\Assets\Photon\PhotonChat\Code\ChannelWellKnownProperties.cs", "C#", 0, 8, 5, 2, 15
"f:\Unity\Marbles Battle Royale (Chenli)\Marbles-Battle-Royale-Online-Game-Development\Marbles Battle Royale (Chenli)\Assets\Photon\PhotonChat\Code\ChatAppSettings.cs", "C#", 0, 35, 24, 14, 73
"f:\Unity\Marbles Battle Royale (Chenli)\Marbles-Battle-Royale-Online-Game-Development\Marbles Battle Royale (Chenli)\Assets\Photon\PhotonChat\Code\ChatChannel.cs", "C#", 0, 131, 34, 28, 193
"f:\Unity\Marbles Battle Royale (Chenli)\Marbles-Battle-Royale-Online-Game-Development\Marbles Battle Royale (Chenli)\Assets\Photon\PhotonChat\Code\ChatClient.cs", "C#", 0, 1296, 357, 176, 1829
"f:\Unity\Marbles Battle Royale (Chenli)\Marbles-Battle-Royale-Online-Game-Development\Marbles Battle Royale (Chenli)\Assets\Photon\PhotonChat\Code\ChatDisconnectCause.cs", "C#", 0, 20, 21, 2, 43
"f:\Unity\Marbles Battle Royale (Chenli)\Marbles-Battle-Royale-Online-Game-Development\Marbles Battle Royale (Chenli)\Assets\Photon\PhotonChat\Code\ChatEventCode.cs", "C#", 0, 17, 20, 3, 40
"f:\Unity\Marbles Battle Royale (Chenli)\Marbles-Battle-Royale-Online-Game-Development\Marbles Battle Royale (Chenli)\Assets\Photon\PhotonChat\Code\ChatOperationCode.cs", "C#", 0, 16, 18, 4, 38
"f:\Unity\Marbles Battle Royale (Chenli)\Marbles-Battle-Royale-Online-Game-Development\Marbles Battle Royale (Chenli)\Assets\Photon\PhotonChat\Code\ChatParameterCode.cs", "C#", 0, 31, 47, 7, 85
"f:\Unity\Marbles Battle Royale (Chenli)\Marbles-Battle-Royale-Online-Game-Development\Marbles Battle Royale (Chenli)\Assets\Photon\PhotonChat\Code\ChatPeer.cs", "C#", 0, 232, 158, 76, 466
"f:\Unity\Marbles Battle Royale (Chenli)\Marbles-Battle-Royale-Online-Game-Development\Marbles Battle Royale (Chenli)\Assets\Photon\PhotonChat\Code\ChatState.cs", "C#", 0, 19, 19, 1, 39
"f:\Unity\Marbles Battle Royale (Chenli)\Marbles-Battle-Royale-Online-Game-Development\Marbles Battle Royale (Chenli)\Assets\Photon\PhotonChat\Code\ChatUserStatus.cs", "C#", 0, 13, 21, 2, 36
"f:\Unity\Marbles Battle Royale (Chenli)\Marbles-Battle-Royale-Online-Game-Development\Marbles Battle Royale (Chenli)\Assets\Photon\PhotonChat\Code\IChatClientListener.cs", "C#", 0, 27, 99, 22, 148
"f:\Unity\Marbles Battle Royale (Chenli)\Marbles-Battle-Royale-Online-Game-Development\Marbles Battle Royale (Chenli)\Assets\Photon\PhotonChat\Demos\Common\EventSystemSpawner.cs", "C#", 0, 23, 13, 4, 40
"f:\Unity\Marbles Battle Royale (Chenli)\Marbles-Battle-Royale-Online-Game-Development\Marbles Battle Royale (Chenli)\Assets\Photon\PhotonChat\Demos\Common\OnStartDelete.cs", "C#", 0, 11, 11, 2, 24
"f:\Unity\Marbles Battle Royale (Chenli)\Marbles-Battle-Royale-Online-Game-Development\Marbles Battle Royale (Chenli)\Assets\Photon\PhotonChat\Demos\Common\TextButtonTransition.cs", "C#", 0, 38, 20, 12, 70
"f:\Unity\Marbles Battle Royale (Chenli)\Marbles-Battle-Royale-Online-Game-Development\Marbles Battle Royale (Chenli)\Assets\Photon\PhotonChat\Demos\Common\TextToggleIsOnTransition.cs", "C#", 0, 41, 26, 19, 86
"f:\Unity\Marbles Battle Royale (Chenli)\Marbles-Battle-Royale-Online-Game-Development\Marbles Battle Royale (Chenli)\Assets\Photon\PhotonChat\Demos\DemoChat\AppSettingsExtensions.cs", "C#", 0, 21, 5, 4, 30
"f:\Unity\Marbles Battle Royale (Chenli)\Marbles-Battle-Royale-Online-Game-Development\Marbles Battle Royale (Chenli)\Assets\Photon\PhotonChat\Demos\DemoChat\ChannelSelector.cs", "C#", 0, 21, 5, 6, 32
"f:\Unity\Marbles Battle Royale (Chenli)\Marbles-Battle-Royale-Online-Game-Development\Marbles Battle Royale (Chenli)\Assets\Photon\PhotonChat\Demos\DemoChat\ChatAppIdCheckerUI.cs", "C#", 0, 37, 9, 8, 54
"f:\Unity\Marbles Battle Royale (Chenli)\Marbles-Battle-Royale-Online-Game-Development\Marbles Battle Royale (Chenli)\Assets\Photon\PhotonChat\Demos\DemoChat\ChatGui.cs", "C#", 0, 462, 69, 118, 649
"f:\Unity\Marbles Battle Royale (Chenli)\Marbles-Battle-Royale-Online-Game-Development\Marbles Battle Royale (Chenli)\Assets\Photon\PhotonChat\Demos\DemoChat\FriendItem.cs", "C#", 0, 63, 10, 11, 84
"f:\Unity\Marbles Battle Royale (Chenli)\Marbles-Battle-Royale-Online-Game-Development\Marbles Battle Royale (Chenli)\Assets\Photon\PhotonChat\Demos\DemoChat\IgnoreUiRaycastWhenInactive.cs", "C#", 0, 11, 5, 4, 20
"f:\Unity\Marbles Battle Royale (Chenli)\Marbles-Battle-Royale-Online-Game-Development\Marbles Battle Royale (Chenli)\Assets\Photon\PhotonChat\Demos\DemoChat\NamePickGui.cs", "C#", 0, 36, 6, 13, 55
"f:\Unity\Marbles Battle Royale (Chenli)\Marbles-Battle-Royale-Online-Game-Development\Marbles Battle Royale (Chenli)\Assets\Photon\PhotonRealtime\Code\AppSettings.cs", "C#", 0, 112, 54, 33, 199
"f:\Unity\Marbles Battle Royale (Chenli)\Marbles-Battle-Royale-Online-Game-Development\Marbles Battle Royale (Chenli)\Assets\Photon\PhotonRealtime\Code\ConnectionHandler.cs", "C#", 0, 126, 33, 40, 199
"f:\Unity\Marbles Battle Royale (Chenli)\Marbles-Battle-Royale-Online-Game-Development\Marbles Battle Royale (Chenli)\Assets\Photon\PhotonRealtime\Code\CustomTypesUnity.cs", "C#", 0, 122, 14, 31, 167
"f:\Unity\Marbles Battle Royale (Chenli)\Marbles-Battle-Royale-Online-Game-Development\Marbles Battle Royale (Chenli)\Assets\Photon\PhotonRealtime\Code\Extensions.cs", "C#", 0, 155, 80, 35, 270
"f:\Unity\Marbles Battle Royale (Chenli)\Marbles-Battle-Royale-Online-Game-Development\Marbles Battle Royale (Chenli)\Assets\Photon\PhotonRealtime\Code\FriendInfo.cs", "C#", 0, 27, 12, 10, 49
"f:\Unity\Marbles Battle Royale (Chenli)\Marbles-Battle-Royale-Online-Game-Development\Marbles Battle Royale (Chenli)\Assets\Photon\PhotonRealtime\Code\LoadBalancingClient.cs", "C#", 0, 514, 3714, 203, 4431
"f:\Unity\Marbles Battle Royale (Chenli)\Marbles-Battle-Royale-Online-Game-Development\Marbles Battle Royale (Chenli)\Assets\Photon\PhotonRealtime\Code\LoadbalancingPeer.cs", "C#", 0, 1082, 760, 395, 2237
"f:\Unity\Marbles Battle Royale (Chenli)\Marbles-Battle-Royale-Online-Game-Development\Marbles Battle Royale (Chenli)\Assets\Photon\PhotonRealtime\Code\PhotonPing.cs", "C#", 0, 371, 32, 77, 480
"f:\Unity\Marbles Battle Royale (Chenli)\Marbles-Battle-Royale-Online-Game-Development\Marbles Battle Royale (Chenli)\Assets\Photon\PhotonRealtime\Code\PhotonPingClasses.cs", "C#", 0, 0, 1, 0, 1
"f:\Unity\Marbles Battle Royale (Chenli)\Marbles-Battle-Royale-Online-Game-Development\Marbles Battle Royale (Chenli)\Assets\Photon\PhotonRealtime\Code\Player.cs", "C#", 0, 230, 164, 58, 452
"f:\Unity\Marbles Battle Royale (Chenli)\Marbles-Battle-Royale-Online-Game-Development\Marbles Battle Royale (Chenli)\Assets\Photon\PhotonRealtime\Code\Region.cs", "C#", 0, 63, 10, 17, 90
"f:\Unity\Marbles Battle Royale (Chenli)\Marbles-Battle-Royale-Online-Game-Development\Marbles Battle Royale (Chenli)\Assets\Photon\PhotonRealtime\Code\RegionHandler.cs", "C#", 0, 500, 83, 117, 700
"f:\Unity\Marbles Battle Royale (Chenli)\Marbles-Battle-Royale-Online-Game-Development\Marbles Battle Royale (Chenli)\Assets\Photon\PhotonRealtime\Code\Room.cs", "C#", 0, 326, 235, 69, 630
"f:\Unity\Marbles Battle Royale (Chenli)\Marbles-Battle-Royale-Online-Game-Development\Marbles Battle Royale (Chenli)\Assets\Photon\PhotonRealtime\Code\RoomInfo.cs", "C#", 0, 142, 89, 44, 275
"f:\Unity\Marbles Battle Royale (Chenli)\Marbles-Battle-Royale-Online-Game-Development\Marbles Battle Royale (Chenli)\Assets\Photon\PhotonRealtime\Code\SupportLogger.cs", "C#", 0, 333, 30, 71, 434
"f:\Unity\Marbles Battle Royale (Chenli)\Marbles-Battle-Royale-Online-Game-Development\Marbles Battle Royale (Chenli)\Assets\Photon\PhotonRealtime\Code\Unity\Editor\AccountService.cs", "C#", 0, 181, 46, 33, 260
"f:\Unity\Marbles Battle Royale (Chenli)\Marbles-Battle-Royale-Online-Game-Development\Marbles Battle Royale (Chenli)\Assets\Photon\PhotonRealtime\Code\Unity\Editor\PhotonEditorUtils.cs", "C#", 0, 232, 49, 52, 333
"f:\Unity\Marbles Battle Royale (Chenli)\Marbles-Battle-Royale-Online-Game-Development\Marbles Battle Royale (Chenli)\Assets\Photon\PhotonRealtime\Code\Unity\PhotonAppSettings.cs", "C#", 0, 73, 20, 23, 116
"f:\Unity\Marbles Battle Royale (Chenli)\Marbles-Battle-Royale-Online-Game-Development\Marbles Battle Royale (Chenli)\Assets\Photon\PhotonRealtime\Code\WebRpc.cs", "C#", 0, 123, 44, 21, 188
"f:\Unity\Marbles Battle Royale (Chenli)\Marbles-Battle-Royale-Online-Game-Development\Marbles Battle Royale (Chenli)\Assets\Photon\PhotonRealtime\Demos\DemoLoadBalancing\ConnectAndJoinRandomLb.cs", "C#", 0, 109, 7, 29, 145
"f:\Unity\Marbles Battle Royale (Chenli)\Marbles-Battle-Royale-Online-Game-Development\Marbles Battle Royale (Chenli)\Assets\Photon\PhotonUnityNetworking\Code\CustomTypes.cs", "C#", 0, 48, 13, 13, 74
"f:\Unity\Marbles Battle Royale (Chenli)\Marbles-Battle-Royale-Online-Game-Development\Marbles Battle Royale (Chenli)\Assets\Photon\PhotonUnityNetworking\Code\Editor\PhotonEditor.cs", "C#", 0, 633, 55, 167, 855
"f:\Unity\Marbles Battle Royale (Chenli)\Marbles-Battle-Royale-Online-Game-Development\Marbles Battle Royale (Chenli)\Assets\Photon\PhotonUnityNetworking\Code\Editor\PhotonGUI.cs", "C#", 0, 273, 11, 79, 363
"f:\Unity\Marbles Battle Royale (Chenli)\Marbles-Battle-Royale-Online-Game-Development\Marbles Battle Royale (Chenli)\Assets\Photon\PhotonUnityNetworking\Code\Editor\PhotonViewHandler.cs", "C#", 0, 125, 29, 37, 191
"f:\Unity\Marbles Battle Royale (Chenli)\Marbles-Battle-Royale-Online-Game-Development\Marbles Battle Royale (Chenli)\Assets\Photon\PhotonUnityNetworking\Code\Editor\PhotonViewInspector.cs", "C#", 0, 277, 42, 75, 394
"f:\Unity\Marbles Battle Royale (Chenli)\Marbles-Battle-Royale-Online-Game-Development\Marbles Battle Royale (Chenli)\Assets\Photon\PhotonUnityNetworking\Code\Editor\PunSceneSettings.cs", "C#", 0, 131, 16, 31, 178
"f:\Unity\Marbles Battle Royale (Chenli)\Marbles-Battle-Royale-Online-Game-Development\Marbles Battle Royale (Chenli)\Assets\Photon\PhotonUnityNetworking\Code\Editor\PunSceneSettingsInspector.cs", "C#", 0, 186, 18, 56, 260
"f:\Unity\Marbles Battle Royale (Chenli)\Marbles-Battle-Royale-Online-Game-Development\Marbles Battle Royale (Chenli)\Assets\Photon\PhotonUnityNetworking\Code\Editor\ReordableList\ReorderableListResources.cs", "C#", 0, 134, 71, 32, 237
"f:\Unity\Marbles Battle Royale (Chenli)\Marbles-Battle-Royale-Online-Game-Development\Marbles Battle Royale (Chenli)\Assets\Photon\PhotonUnityNetworking\Code\Editor\ServerSettingsInspector.cs", "C#", 0, 233, 15, 74, 322
"f:\Unity\Marbles Battle Royale (Chenli)\Marbles-Battle-Royale-Online-Game-Development\Marbles Battle Royale (Chenli)\Assets\Photon\PhotonUnityNetworking\Code\Editor\Views\MonoBehaviourPunEditor.cs", "C#", 0, 23, 9, 9, 41
"f:\Unity\Marbles Battle Royale (Chenli)\Marbles-Battle-Royale-Online-Game-Development\Marbles Battle Royale (Chenli)\Assets\Photon\PhotonUnityNetworking\Code\Editor\Views\PhotonAnimatorViewEditor.cs", "C#", 0, 225, 14, 56, 295
"f:\Unity\Marbles Battle Royale (Chenli)\Marbles-Battle-Royale-Online-Game-Development\Marbles Battle Royale (Chenli)\Assets\Photon\PhotonUnityNetworking\Code\Editor\Views\PhotonRigidbody2DViewEditor.cs", "C#", 0, 31, 9, 10, 50
"f:\Unity\Marbles Battle Royale (Chenli)\Marbles-Battle-Royale-Online-Game-Development\Marbles Battle Royale (Chenli)\Assets\Photon\PhotonUnityNetworking\Code\Editor\Views\PhotonRigidbodyViewEditor.cs", "C#", 0, 31, 9, 10, 50
"f:\Unity\Marbles Battle Royale (Chenli)\Marbles-Battle-Royale-Online-Game-Development\Marbles Battle Royale (Chenli)\Assets\Photon\PhotonUnityNetworking\Code\Editor\Views\PhotonTransformViewClassicEditor.cs", "C#", 0, 297, 34, 81, 412
"f:\Unity\Marbles Battle Royale (Chenli)\Marbles-Battle-Royale-Online-Game-Development\Marbles Battle Royale (Chenli)\Assets\Photon\PhotonUnityNetworking\Code\Editor\Views\PhotonTransformViewEditor.cs", "C#", 0, 48, 9, 15, 72
"f:\Unity\Marbles Battle Royale (Chenli)\Marbles-Battle-Royale-Online-Game-Development\Marbles Battle Royale (Chenli)\Assets\Photon\PhotonUnityNetworking\Code\Enums.cs", "C#", 0, 27, 49, 18, 94
"f:\Unity\Marbles Battle Royale (Chenli)\Marbles-Battle-Royale-Online-Game-Development\Marbles Battle Royale (Chenli)\Assets\Photon\PhotonUnityNetworking\Code\Interfaces\IPhotonViewCallbacks.cs", "C#", 0, 19, 26, 6, 51
"f:\Unity\Marbles Battle Royale (Chenli)\Marbles-Battle-Royale-Online-Game-Development\Marbles Battle Royale (Chenli)\Assets\Photon\PhotonUnityNetworking\Code\Interfaces\IPunCallbacks.cs", "C#", 0, 24, 107, 10, 141
"f:\Unity\Marbles Battle Royale (Chenli)\Marbles-Battle-Royale-Online-Game-Development\Marbles Battle Royale (Chenli)\Assets\Photon\PhotonUnityNetworking\Code\PhotonHandler.cs", "C#", 0, 280, 50, 71, 401
"f:\Unity\Marbles Battle Royale (Chenli)\Marbles-Battle-Royale-Online-Game-Development\Marbles Battle Royale (Chenli)\Assets\Photon\PhotonUnityNetworking\Code\PhotonNetwork.cs", "C#", 0, 1693, 1230, 390, 3313
"f:\Unity\Marbles Battle Royale (Chenli)\Marbles-Battle-Royale-Online-Game-Development\Marbles Battle Royale (Chenli)\Assets\Photon\PhotonUnityNetworking\Code\PhotonNetworkPart.cs", "C#", 0, 1749, 420, 391, 2560
"f:\Unity\Marbles Battle Royale (Chenli)\Marbles-Battle-Royale-Online-Game-Development\Marbles Battle Royale (Chenli)\Assets\Photon\PhotonUnityNetworking\Code\PhotonStreamQueue.cs", "C#", 0, 113, 52, 32, 197
"f:\Unity\Marbles Battle Royale (Chenli)\Marbles-Battle-Royale-Online-Game-Development\Marbles Battle Royale (Chenli)\Assets\Photon\PhotonUnityNetworking\Code\PhotonView.cs", "C#", 0, 472, 224, 130, 826
"f:\Unity\Marbles Battle Royale (Chenli)\Marbles-Battle-Royale-Online-Game-Development\Marbles Battle Royale (Chenli)\Assets\Photon\PhotonUnityNetworking\Code\PunClasses.cs", "C#", 0, 521, 348, 105, 974
"f:\Unity\Marbles Battle Royale (Chenli)\Marbles-Battle-Royale-Online-Game-Development\Marbles Battle Royale (Chenli)\Assets\Photon\PhotonUnityNetworking\Code\ServerSettings.cs", "C#", 0, 62, 23, 15, 100
"f:\Unity\Marbles Battle Royale (Chenli)\Marbles-Battle-Royale-Online-Game-Development\Marbles Battle Royale (Chenli)\Assets\Photon\PhotonUnityNetworking\Code\Utilities\NestedComponentUtilities.cs", "C#", 0, 292, 100, 102, 494
"f:\Unity\Marbles Battle Royale (Chenli)\Marbles-Battle-Royale-Online-Game-Development\Marbles Battle Royale (Chenli)\Assets\Photon\PhotonUnityNetworking\Code\Views\PhotonAnimatorView.cs", "C#", 0, 408, 68, 96, 572
"f:\Unity\Marbles Battle Royale (Chenli)\Marbles-Battle-Royale-Online-Game-Development\Marbles Battle Royale (Chenli)\Assets\Photon\PhotonUnityNetworking\Code\Views\PhotonRigidbody2DView.cs", "C#", 0, 79, 9, 23, 111
"f:\Unity\Marbles Battle Royale (Chenli)\Marbles-Battle-Royale-Online-Game-Development\Marbles Battle Royale (Chenli)\Assets\Photon\PhotonUnityNetworking\Code\Views\PhotonRigidbodyView.cs", "C#", 0, 80, 9, 23, 112
"f:\Unity\Marbles Battle Royale (Chenli)\Marbles-Battle-Royale-Online-Game-Development\Marbles Battle Royale (Chenli)\Assets\Photon\PhotonUnityNetworking\Code\Views\PhotonTransformView.cs", "C#", 0, 155, 12, 27, 194
"f:\Unity\Marbles Battle Royale (Chenli)\Marbles-Battle-Royale-Online-Game-Development\Marbles Battle Royale (Chenli)\Assets\Photon\PhotonUnityNetworking\Code\Views\PhotonTransformViewClassic.cs", "C#", 0, 389, 70, 98, 557
"f:\Unity\Marbles Battle Royale (Chenli)\Marbles-Battle-Royale-Online-Game-Development\Marbles Battle Royale (Chenli)\Assets\Photon\PhotonUnityNetworking\UtilityScripts\Culling\CullArea.cs", "C#", 0, 281, 144, 76, 501
"f:\Unity\Marbles Battle Royale (Chenli)\Marbles-Battle-Royale-Online-Game-Development\Marbles Battle Royale (Chenli)\Assets\Photon\PhotonUnityNetworking\UtilityScripts\Culling\CullingHandler.cs", "C#", 0, 159, 47, 48, 254
"f:\Unity\Marbles Battle Royale (Chenli)\Marbles-Battle-Royale-Online-Game-Development\Marbles Battle Royale (Chenli)\Assets\Photon\PhotonUnityNetworking\UtilityScripts\Culling\Editor\CullAreaEditor.cs", "C#", 0, 183, 25, 57, 265
"f:\Unity\Marbles Battle Royale (Chenli)\Marbles-Battle-Royale-Online-Game-Development\Marbles Battle Royale (Chenli)\Assets\Photon\PhotonUnityNetworking\UtilityScripts\Debugging\PhotonLagSimulationGui.cs", "C#", 0, 67, 21, 21, 109
"f:\Unity\Marbles Battle Royale (Chenli)\Marbles-Battle-Royale-Online-Game-Development\Marbles Battle Royale (Chenli)\Assets\Photon\PhotonUnityNetworking\UtilityScripts\Debugging\PhotonStatsGui.cs", "C#", 0, 114, 32, 24, 170
"f:\Unity\Marbles Battle Royale (Chenli)\Marbles-Battle-Royale-Online-Game-Development\Marbles Battle Royale (Chenli)\Assets\Photon\PhotonUnityNetworking\UtilityScripts\Debugging\PointedAtGameObjectInfo.cs", "C#", 0, 56, 12, 16, 84
"f:\Unity\Marbles Battle Royale (Chenli)\Marbles-Battle-Royale-Online-Game-Development\Marbles Battle Royale (Chenli)\Assets\Photon\PhotonUnityNetworking\UtilityScripts\Debugging\StatesGui.cs", "C#", 0, 176, 12, 24, 212
"f:\Unity\Marbles Battle Royale (Chenli)\Marbles-Battle-Royale-Online-Game-Development\Marbles Battle Royale (Chenli)\Assets\Photon\PhotonUnityNetworking\UtilityScripts\PhotonPlayer\Editor\PhotonTeamsManagerInspector.cs", "C#", 0, 217, 18, 11, 246
"f:\Unity\Marbles Battle Royale (Chenli)\Marbles-Battle-Royale-Online-Game-Development\Marbles Battle Royale (Chenli)\Assets\Photon\PhotonUnityNetworking\UtilityScripts\PhotonPlayer\Editor\PlayerNumberingInspector.cs", "C#", 0, 43, 13, 11, 67
"f:\Unity\Marbles Battle Royale (Chenli)\Marbles-Battle-Royale-Online-Game-Development\Marbles Battle Royale (Chenli)\Assets\Photon\PhotonUnityNetworking\UtilityScripts\PhotonPlayer\Editor\PunTeamsInspector.cs", "C#", 0, 43, 9, 13, 65
"f:\Unity\Marbles Battle Royale (Chenli)\Marbles-Battle-Royale-Online-Game-Development\Marbles Battle Royale (Chenli)\Assets\Photon\PhotonUnityNetworking\UtilityScripts\PhotonPlayer\PhotonTeamsManager.cs", "C#", 0, 440, 129, 59, 628
"f:\Unity\Marbles Battle Royale (Chenli)\Marbles-Battle-Royale-Online-Game-Development\Marbles Battle Royale (Chenli)\Assets\Photon\PhotonUnityNetworking\UtilityScripts\PhotonPlayer\PlayerNumbering.cs", "C#", 0, 160, 55, 52, 267
"f:\Unity\Marbles Battle Royale (Chenli)\Marbles-Battle-Royale-Online-Game-Development\Marbles Battle Royale (Chenli)\Assets\Photon\PhotonUnityNetworking\UtilityScripts\PhotonPlayer\PunPlayerScores.cs", "C#", 0, 39, 12, 11, 62
"f:\Unity\Marbles Battle Royale (Chenli)\Marbles-Battle-Royale-Online-Game-Development\Marbles Battle Royale (Chenli)\Assets\Photon\PhotonUnityNetworking\UtilityScripts\PhotonPlayer\PunTeams.cs", "C#", 0, 98, 35, 23, 156
"f:\Unity\Marbles Battle Royale (Chenli)\Marbles-Battle-Royale-Online-Game-Development\Marbles Battle Royale (Chenli)\Assets\Photon\PhotonUnityNetworking\UtilityScripts\PhotonView\SmoothSyncMovement.cs", "C#", 0, 50, 15, 7, 72
"f:\Unity\Marbles Battle Royale (Chenli)\Marbles-Battle-Royale-Online-Game-Development\Marbles Battle Royale (Chenli)\Assets\Photon\PhotonUnityNetworking\UtilityScripts\Prototyping\ConnectAndJoinRandom.cs", "C#", 0, 53, 53, 31, 137
"f:\Unity\Marbles Battle Royale (Chenli)\Marbles-Battle-Royale-Online-Game-Development\Marbles Battle Royale (Chenli)\Assets\Photon\PhotonUnityNetworking\UtilityScripts\Prototyping\MoveByKeys.cs", "C#", 0, 64, 33, 14, 111
"f:\Unity\Marbles Battle Royale (Chenli)\Marbles-Battle-Royale-Online-Game-Development\Marbles Battle Royale (Chenli)\Assets\Photon\PhotonUnityNetworking\UtilityScripts\Prototyping\OnClickDestroy.cs", "C#", 0, 33, 29, 10, 72
"f:\Unity\Marbles Battle Royale (Chenli)\Marbles-Battle-Royale-Online-Game-Development\Marbles Battle Royale (Chenli)\Assets\Photon\PhotonUnityNetworking\UtilityScripts\Prototyping\OnClickInstantiate.cs", "C#", 0, 30, 14, 12, 56
"f:\Unity\Marbles Battle Royale (Chenli)\Marbles-Battle-Royale-Online-Game-Development\Marbles Battle Royale (Chenli)\Assets\Photon\PhotonUnityNetworking\UtilityScripts\Prototyping\OnClickRpc.cs", "C#", 0, 57, 12, 20, 89
"f:\Unity\Marbles Battle Royale (Chenli)\Marbles-Battle-Royale-Online-Game-Development\Marbles Battle Royale (Chenli)\Assets\Photon\PhotonUnityNetworking\UtilityScripts\Prototyping\OnEscapeQuit.cs", "C#", 0, 17, 13, 2, 32
"f:\Unity\Marbles Battle Royale (Chenli)\Marbles-Battle-Royale-Online-Game-Development\Marbles Battle Royale (Chenli)\Assets\Photon\PhotonUnityNetworking\UtilityScripts\Prototyping\OnJoinedInstantiate.cs", "C#", 0, 300, 58, 93, 451
"f:\Unity\Marbles Battle Royale (Chenli)\Marbles-Battle-Royale-Online-Game-Development\Marbles Battle Royale (Chenli)\Assets\Photon\PhotonUnityNetworking\UtilityScripts\Prototyping\OnStartDelete.cs", "C#", 0, 11, 11, 2, 24
"f:\Unity\Marbles Battle Royale (Chenli)\Marbles-Battle-Royale-Online-Game-Development\Marbles Battle Royale (Chenli)\Assets\Photon\PhotonUnityNetworking\UtilityScripts\Room\CountdownTimer.cs", "C#", 0, 101, 33, 42, 176
"f:\Unity\Marbles Battle Royale (Chenli)\Marbles-Battle-Royale-Online-Game-Development\Marbles Battle Royale (Chenli)\Assets\Photon\PhotonUnityNetworking\UtilityScripts\TurnBased\PunTurnManager.cs", "C#", 0, 206, 146, 78, 430
"f:\Unity\Marbles Battle Royale (Chenli)\Marbles-Battle-Royale-Online-Game-Development\Marbles Battle Royale (Chenli)\Assets\Photon\PhotonUnityNetworking\UtilityScripts\UI\ButtonInsideScrollList.cs", "C#", 0, 31, 14, 8, 53
"f:\Unity\Marbles Battle Royale (Chenli)\Marbles-Battle-Royale-Online-Game-Development\Marbles Battle Royale (Chenli)\Assets\Photon\PhotonUnityNetworking\UtilityScripts\UI\EventSystemSpawner.cs", "C#", 0, 23, 13, 4, 40
"f:\Unity\Marbles Battle Royale (Chenli)\Marbles-Battle-Royale-Online-Game-Development\Marbles Battle Royale (Chenli)\Assets\Photon\PhotonUnityNetworking\UtilityScripts\UI\GraphicToggleIsOnTransition.cs", "C#", 0, 41, 11, 12, 64
"f:\Unity\Marbles Battle Royale (Chenli)\Marbles-Battle-Royale-Online-Game-Development\Marbles Battle Royale (Chenli)\Assets\Photon\PhotonUnityNetworking\UtilityScripts\UI\OnPointerOverTooltip.cs", "C#", 0, 24, 10, 11, 45
"f:\Unity\Marbles Battle Royale (Chenli)\Marbles-Battle-Royale-Online-Game-Development\Marbles Battle Royale (Chenli)\Assets\Photon\PhotonUnityNetworking\UtilityScripts\UI\TabViewManager.cs", "C#", 0, 65, 33, 25, 123
"f:\Unity\Marbles Battle Royale (Chenli)\Marbles-Battle-Royale-Online-Game-Development\Marbles Battle Royale (Chenli)\Assets\Photon\PhotonUnityNetworking\UtilityScripts\UI\TextButtonTransition.cs", "C#", 0, 38, 20, 12, 70
"f:\Unity\Marbles Battle Royale (Chenli)\Marbles-Battle-Royale-Online-Game-Development\Marbles Battle Royale (Chenli)\Assets\Photon\PhotonUnityNetworking\UtilityScripts\UI\TextToggleIsOnTransition.cs", "C#", 0, 41, 26, 19, 86
"f:\Unity\Marbles Battle Royale (Chenli)\Marbles-Battle-Royale-Online-Game-Development\Marbles Battle Royale (Chenli)\Assets\Photon\PhotonUnityNetworking\link.xml", "XML", 14, 0, 0, 0, 14
"f:\Unity\Marbles Battle Royale (Chenli)\Marbles-Battle-Royale-Online-Game-Development\Marbles Battle Royale (Chenli)\Assets\Scripts\AnimateLoading.cs", "C#", 0, -22, -4, -4, -30
"f:\Unity\Marbles Battle Royale (Chenli)\Marbles-Battle-Royale-Online-Game-Development\Marbles Battle Royale (Chenli)\Assets\Scripts\Billboard.cs", "C#", 0, -46, -3, -3, -52
"f:\Unity\Marbles Battle Royale (Chenli)\Marbles-Battle-Royale-Online-Game-Development\Marbles Battle Royale (Chenli)\Assets\Scripts\ButtonSoundCtrl.cs", "C#", 0, -16, -2, -5, -23
"f:\Unity\Marbles Battle Royale (Chenli)\Marbles-Battle-Royale-Online-Game-Development\Marbles Battle Royale (Chenli)\Assets\Scripts\CameraMove.cs", "C#", 0, -55, -2, -15, -72
"f:\Unity\Marbles Battle Royale (Chenli)\Marbles-Battle-Royale-Online-Game-Development\Marbles Battle Royale (Chenli)\Assets\Scripts\CollisionDetect.cs", "C#", 0, -212, -92, -42, -346
"f:\Unity\Marbles Battle Royale (Chenli)\Marbles-Battle-Royale-Online-Game-Development\Marbles Battle Royale (Chenli)\Assets\Scripts\CollisionTrigger.cs", "C#", 0, -36, -41, -17, -94
"f:\Unity\Marbles Battle Royale (Chenli)\Marbles-Battle-Royale-Online-Game-Development\Marbles Battle Royale (Chenli)\Assets\Scripts\GameSetting.cs", "C#", 0, -22, -3, -3, -28
"f:\Unity\Marbles Battle Royale (Chenli)\Marbles-Battle-Royale-Online-Game-Development\Marbles Battle Royale (Chenli)\Assets\Scripts\InGameUIManager.cs", "C#", 0, -74, -14, -7, -95
"f:\Unity\Marbles Battle Royale (Chenli)\Marbles-Battle-Royale-Online-Game-Development\Marbles Battle Royale (Chenli)\Assets\Scripts\JumpController.cs", "C#", 0, -119, -28, -23, -170
"f:\Unity\Marbles Battle Royale (Chenli)\Marbles-Battle-Royale-Online-Game-Development\Marbles Battle Royale (Chenli)\Assets\Scripts\JumpPad.cs", "C#", 0, -14, 0, -2, -16
"f:\Unity\Marbles Battle Royale (Chenli)\Marbles-Battle-Royale-Online-Game-Development\Marbles Battle Royale (Chenli)\Assets\Scripts\Keep.cs", "C#", 0, -51, -16, -15, -82
"f:\Unity\Marbles Battle Royale (Chenli)\Marbles-Battle-Royale-Online-Game-Development\Marbles Battle Royale (Chenli)\Assets\Scripts\LeftandRight.cs", "C#", 0, -53, -15, -15, -83
"f:\Unity\Marbles Battle Royale (Chenli)\Marbles-Battle-Royale-Online-Game-Development\Marbles Battle Royale (Chenli)\Assets\Scripts\Menu Scrips\Menu.cs", "C#", 0, -24, -1, -7, -32
"f:\Unity\Marbles Battle Royale (Chenli)\Marbles-Battle-Royale-Online-Game-Development\Marbles Battle Royale (Chenli)\Assets\Scripts\Menu Scrips\MenuManager.cs", "C#", 0, -91, -17, -13, -121
"f:\Unity\Marbles Battle Royale (Chenli)\Marbles-Battle-Royale-Online-Game-Development\Marbles Battle Royale (Chenli)\Assets\Scripts\Menu Scrips\NetworkManager.cs", "C#", 0, -250, -32, -44, -326
"f:\Unity\Marbles Battle Royale (Chenli)\Marbles-Battle-Royale-Online-Game-Development\Marbles Battle Royale (Chenli)\Assets\Scripts\Menu Scrips\PlayerListItem.cs", "C#", 0, -24, -4, -6, -34
"f:\Unity\Marbles Battle Royale (Chenli)\Marbles-Battle-Royale-Online-Game-Development\Marbles Battle Royale (Chenli)\Assets\Scripts\Menu Scrips\PlayerManager.cs", "C#", 0, -233, -43, -38, -314
"f:\Unity\Marbles Battle Royale (Chenli)\Marbles-Battle-Royale-Online-Game-Development\Marbles Battle Royale (Chenli)\Assets\Scripts\Menu Scrips\RoomListItem.cs", "C#", 0, -19, 0, -6, -25
"f:\Unity\Marbles Battle Royale (Chenli)\Marbles-Battle-Royale-Online-Game-Development\Marbles Battle Royale (Chenli)\Assets\Scripts\Menu Scrips\RoomManager.cs", "C#", 0, -56, -7, -15, -78
"f:\Unity\Marbles Battle Royale (Chenli)\Marbles-Battle-Royale-Online-Game-Development\Marbles Battle Royale (Chenli)\Assets\Scripts\Menu Scrips\RotateAndShake.cs", "C#", 0, -60, -4, -16, -80
"f:\Unity\Marbles Battle Royale (Chenli)\Marbles-Battle-Royale-Online-Game-Development\Marbles Battle Royale (Chenli)\Assets\Scripts\MovementController.cs", "C#", 0, -163, -20, -20, -203
"f:\Unity\Marbles Battle Royale (Chenli)\Marbles-Battle-Royale-Online-Game-Development\Marbles Battle Royale (Chenli)\Assets\Scripts\ParticleFollow.cs", "C#", 0, -47, -15, -9, -71
"f:\Unity\Marbles Battle Royale (Chenli)\Marbles-Battle-Royale-Online-Game-Development\Marbles Battle Royale (Chenli)\Assets\Scripts\ScoreBoard.cs", "C#", 0, -66, -3, -8, -77
"f:\Unity\Marbles Battle Royale (Chenli)\Marbles-Battle-Royale-Online-Game-Development\Marbles Battle Royale (Chenli)\Assets\Scripts\ScoreBoardManager.cs", "C#", 0, -61, -37, -13, -111
"f:\Unity\Marbles Battle Royale (Chenli)\Marbles-Battle-Royale-Online-Game-Development\Marbles Battle Royale (Chenli)\Assets\Scripts\SoundController.cs", "C#", 0, -25, -6, -6, -37
"f:\Unity\Marbles Battle Royale (Chenli)\Marbles-Battle-Royale-Online-Game-Development\Marbles Battle Royale (Chenli)\Assets\Scripts\SpectatorMovement.cs", "C#", 0, -84, -12, -11, -107
"f:\Unity\Marbles Battle Royale (Chenli)\Marbles-Battle-Royale-Online-Game-Development\Marbles Battle Royale (Chenli)\Assets\Scripts\TouchUp.cs", "C#", 0, -44, -30, -15, -89
"f:\Unity\Marbles Battle Royale (Chenli)\Marbles-Battle-Royale-Online-Game-Development\Marbles Battle Royale (Chenli)\Assets\Scripts\WallFoward.cs", "C#", 0, -18, -1, -5, -24
"f:\Unity\Marbles Battle Royale (Chenli)\Marbles-Battle-Royale-Online-Game-Development\Marbles Battle Royale (Chenli)\Assets\Scripts\cameraDist.cs", "C#", 0, -48, -10, -7, -65
"f:\Unity\Marbles Battle Royale (Chenli)\Marbles-Battle-Royale-Online-Game-Development\Marbles Battle Royale (Chenli)\Assets\Scripts\getspeed.cs", "C#", 0, -23, -4, -7, -34
"f:\Unity\Marbles Battle Royale (Chenli)\Marbles-Battle-Royale-Online-Game-Development\Marbles Battle Royale (Chenli)\Assets\Scripts\maincamera.cs", "C#", 0, -124, -13, -24, -161
"Total", "-", 14, 17581, 10267, 4608, 32470