"filename", "language", "C#", "XML", "comment", "blank", "total"
"f:\Unity\Marbles Battle Royale (Chenli)\Marbles-Battle-Royale-Online-Game-Development\Marbles Battle Royale (Chenli)\Assets\Photon\PhotonChat\Code\ChannelCreationOptions.cs", "C#", -12, 0, -8, -3, -23
"f:\Unity\Marbles Battle Royale (Chenli)\Marbles-Battle-Royale-Online-Game-Development\Marbles Battle Royale (Chenli)\Assets\Photon\PhotonChat\Code\ChannelWellKnownProperties.cs", "C#", -8, 0, -5, -2, -15
"f:\Unity\Marbles Battle Royale (Chenli)\Marbles-Battle-Royale-Online-Game-Development\Marbles Battle Royale (Chenli)\Assets\Photon\PhotonChat\Code\ChatAppSettings.cs", "C#", -35, 0, -24, -14, -73
"f:\Unity\Marbles Battle Royale (Chenli)\Marbles-Battle-Royale-Online-Game-Development\Marbles Battle Royale (Chenli)\Assets\Photon\PhotonChat\Code\ChatChannel.cs", "C#", -131, 0, -34, -28, -193
"f:\Unity\Marbles Battle Royale (Chenli)\Marbles-Battle-Royale-Online-Game-Development\Marbles Battle Royale (Chenli)\Assets\Photon\PhotonChat\Code\ChatClient.cs", "C#", -1296, 0, -357, -176, -1829
"f:\Unity\Marbles Battle Royale (Chenli)\Marbles-Battle-Royale-Online-Game-Development\Marbles Battle Royale (Chenli)\Assets\Photon\PhotonChat\Code\ChatDisconnectCause.cs", "C#", -20, 0, -21, -2, -43
"f:\Unity\Marbles Battle Royale (Chenli)\Marbles-Battle-Royale-Online-Game-Development\Marbles Battle Royale (Chenli)\Assets\Photon\PhotonChat\Code\ChatEventCode.cs", "C#", -17, 0, -20, -3, -40
"f:\Unity\Marbles Battle Royale (Chenli)\Marbles-Battle-Royale-Online-Game-Development\Marbles Battle Royale (Chenli)\Assets\Photon\PhotonChat\Code\ChatOperationCode.cs", "C#", -16, 0, -18, -4, -38
"f:\Unity\Marbles Battle Royale (Chenli)\Marbles-Battle-Royale-Online-Game-Development\Marbles Battle Royale (Chenli)\Assets\Photon\PhotonChat\Code\ChatParameterCode.cs", "C#", -31, 0, -47, -7, -85
"f:\Unity\Marbles Battle Royale (Chenli)\Marbles-Battle-Royale-Online-Game-Development\Marbles Battle Royale (Chenli)\Assets\Photon\PhotonChat\Code\ChatPeer.cs", "C#", -232, 0, -158, -76, -466
"f:\Unity\Marbles Battle Royale (Chenli)\Marbles-Battle-Royale-Online-Game-Development\Marbles Battle Royale (Chenli)\Assets\Photon\PhotonChat\Code\ChatState.cs", "C#", -19, 0, -19, -1, -39
"f:\Unity\Marbles Battle Royale (Chenli)\Marbles-Battle-Royale-Online-Game-Development\Marbles Battle Royale (Chenli)\Assets\Photon\PhotonChat\Code\ChatUserStatus.cs", "C#", -13, 0, -21, -2, -36
"f:\Unity\Marbles Battle Royale (Chenli)\Marbles-Battle-Royale-Online-Game-Development\Marbles Battle Royale (Chenli)\Assets\Photon\PhotonChat\Code\IChatClientListener.cs", "C#", -27, 0, -99, -22, -148
"f:\Unity\Marbles Battle Royale (Chenli)\Marbles-Battle-Royale-Online-Game-Development\Marbles Battle Royale (Chenli)\Assets\Photon\PhotonChat\Demos\Common\EventSystemSpawner.cs", "C#", -23, 0, -13, -4, -40
"f:\Unity\Marbles Battle Royale (Chenli)\Marbles-Battle-Royale-Online-Game-Development\Marbles Battle Royale (Chenli)\Assets\Photon\PhotonChat\Demos\Common\OnStartDelete.cs", "C#", -11, 0, -11, -2, -24
"f:\Unity\Marbles Battle Royale (Chenli)\Marbles-Battle-Royale-Online-Game-Development\Marbles Battle Royale (Chenli)\Assets\Photon\PhotonChat\Demos\Common\TextButtonTransition.cs", "C#", -38, 0, -20, -12, -70
"f:\Unity\Marbles Battle Royale (Chenli)\Marbles-Battle-Royale-Online-Game-Development\Marbles Battle Royale (Chenli)\Assets\Photon\PhotonChat\Demos\Common\TextToggleIsOnTransition.cs", "C#", -41, 0, -26, -19, -86
"f:\Unity\Marbles Battle Royale (Chenli)\Marbles-Battle-Royale-Online-Game-Development\Marbles Battle Royale (Chenli)\Assets\Photon\PhotonChat\Demos\DemoChat\AppSettingsExtensions.cs", "C#", -21, 0, -5, -4, -30
"f:\Unity\Marbles Battle Royale (Chenli)\Marbles-Battle-Royale-Online-Game-Development\Marbles Battle Royale (Chenli)\Assets\Photon\PhotonChat\Demos\DemoChat\ChannelSelector.cs", "C#", -21, 0, -5, -6, -32
"f:\Unity\Marbles Battle Royale (Chenli)\Marbles-Battle-Royale-Online-Game-Development\Marbles Battle Royale (Chenli)\Assets\Photon\PhotonChat\Demos\DemoChat\ChatAppIdCheckerUI.cs", "C#", -37, 0, -9, -8, -54
"f:\Unity\Marbles Battle Royale (Chenli)\Marbles-Battle-Royale-Online-Game-Development\Marbles Battle Royale (Chenli)\Assets\Photon\PhotonChat\Demos\DemoChat\ChatGui.cs", "C#", -462, 0, -69, -118, -649
"f:\Unity\Marbles Battle Royale (Chenli)\Marbles-Battle-Royale-Online-Game-Development\Marbles Battle Royale (Chenli)\Assets\Photon\PhotonChat\Demos\DemoChat\FriendItem.cs", "C#", -63, 0, -10, -11, -84
"f:\Unity\Marbles Battle Royale (Chenli)\Marbles-Battle-Royale-Online-Game-Development\Marbles Battle Royale (Chenli)\Assets\Photon\PhotonChat\Demos\DemoChat\IgnoreUiRaycastWhenInactive.cs", "C#", -11, 0, -5, -4, -20
"f:\Unity\Marbles Battle Royale (Chenli)\Marbles-Battle-Royale-Online-Game-Development\Marbles Battle Royale (Chenli)\Assets\Photon\PhotonChat\Demos\DemoChat\NamePickGui.cs", "C#", -36, 0, -6, -13, -55
"f:\Unity\Marbles Battle Royale (Chenli)\Marbles-Battle-Royale-Online-Game-Development\Marbles Battle Royale (Chenli)\Assets\Photon\PhotonRealtime\Code\AppSettings.cs", "C#", -112, 0, -54, -33, -199
"f:\Unity\Marbles Battle Royale (Chenli)\Marbles-Battle-Royale-Online-Game-Development\Marbles Battle Royale (Chenli)\Assets\Photon\PhotonRealtime\Code\ConnectionHandler.cs", "C#", -126, 0, -33, -40, -199
"f:\Unity\Marbles Battle Royale (Chenli)\Marbles-Battle-Royale-Online-Game-Development\Marbles Battle Royale (Chenli)\Assets\Photon\PhotonRealtime\Code\CustomTypesUnity.cs", "C#", -122, 0, -14, -31, -167
"f:\Unity\Marbles Battle Royale (Chenli)\Marbles-Battle-Royale-Online-Game-Development\Marbles Battle Royale (Chenli)\Assets\Photon\PhotonRealtime\Code\Extensions.cs", "C#", -155, 0, -80, -35, -270
"f:\Unity\Marbles Battle Royale (Chenli)\Marbles-Battle-Royale-Online-Game-Development\Marbles Battle Royale (Chenli)\Assets\Photon\PhotonRealtime\Code\FriendInfo.cs", "C#", -27, 0, -12, -10, -49
"f:\Unity\Marbles Battle Royale (Chenli)\Marbles-Battle-Royale-Online-Game-Development\Marbles Battle Royale (Chenli)\Assets\Photon\PhotonRealtime\Code\LoadBalancingClient.cs", "C#", -514, 0, -3714, -203, -4431
"f:\Unity\Marbles Battle Royale (Chenli)\Marbles-Battle-Royale-Online-Game-Development\Marbles Battle Royale (Chenli)\Assets\Photon\PhotonRealtime\Code\LoadbalancingPeer.cs", "C#", -1082, 0, -760, -395, -2237
"f:\Unity\Marbles Battle Royale (Chenli)\Marbles-Battle-Royale-Online-Game-Development\Marbles Battle Royale (Chenli)\Assets\Photon\PhotonRealtime\Code\PhotonPing.cs", "C#", -371, 0, -32, -77, -480
"f:\Unity\Marbles Battle Royale (Chenli)\Marbles-Battle-Royale-Online-Game-Development\Marbles Battle Royale (Chenli)\Assets\Photon\PhotonRealtime\Code\PhotonPingClasses.cs", "C#", 0, 0, -1, 0, -1
"f:\Unity\Marbles Battle Royale (Chenli)\Marbles-Battle-Royale-Online-Game-Development\Marbles Battle Royale (Chenli)\Assets\Photon\PhotonRealtime\Code\Player.cs", "C#", -230, 0, -164, -58, -452
"f:\Unity\Marbles Battle Royale (Chenli)\Marbles-Battle-Royale-Online-Game-Development\Marbles Battle Royale (Chenli)\Assets\Photon\PhotonRealtime\Code\Region.cs", "C#", -63, 0, -10, -17, -90
"f:\Unity\Marbles Battle Royale (Chenli)\Marbles-Battle-Royale-Online-Game-Development\Marbles Battle Royale (Chenli)\Assets\Photon\PhotonRealtime\Code\RegionHandler.cs", "C#", -500, 0, -83, -117, -700
"f:\Unity\Marbles Battle Royale (Chenli)\Marbles-Battle-Royale-Online-Game-Development\Marbles Battle Royale (Chenli)\Assets\Photon\PhotonRealtime\Code\Room.cs", "C#", -326, 0, -235, -69, -630
"f:\Unity\Marbles Battle Royale (Chenli)\Marbles-Battle-Royale-Online-Game-Development\Marbles Battle Royale (Chenli)\Assets\Photon\PhotonRealtime\Code\RoomInfo.cs", "C#", -142, 0, -89, -44, -275
"f:\Unity\Marbles Battle Royale (Chenli)\Marbles-Battle-Royale-Online-Game-Development\Marbles Battle Royale (Chenli)\Assets\Photon\PhotonRealtime\Code\SupportLogger.cs", "C#", -333, 0, -30, -71, -434
"f:\Unity\Marbles Battle Royale (Chenli)\Marbles-Battle-Royale-Online-Game-Development\Marbles Battle Royale (Chenli)\Assets\Photon\PhotonRealtime\Code\Unity\Editor\AccountService.cs", "C#", -181, 0, -46, -33, -260
"f:\Unity\Marbles Battle Royale (Chenli)\Marbles-Battle-Royale-Online-Game-Development\Marbles Battle Royale (Chenli)\Assets\Photon\PhotonRealtime\Code\Unity\Editor\PhotonEditorUtils.cs", "C#", -232, 0, -49, -52, -333
"f:\Unity\Marbles Battle Royale (Chenli)\Marbles-Battle-Royale-Online-Game-Development\Marbles Battle Royale (Chenli)\Assets\Photon\PhotonRealtime\Code\Unity\PhotonAppSettings.cs", "C#", -73, 0, -20, -23, -116
"f:\Unity\Marbles Battle Royale (Chenli)\Marbles-Battle-Royale-Online-Game-Development\Marbles Battle Royale (Chenli)\Assets\Photon\PhotonRealtime\Code\WebRpc.cs", "C#", -123, 0, -44, -21, -188
"f:\Unity\Marbles Battle Royale (Chenli)\Marbles-Battle-Royale-Online-Game-Development\Marbles Battle Royale (Chenli)\Assets\Photon\PhotonRealtime\Demos\DemoLoadBalancing\ConnectAndJoinRandomLb.cs", "C#", -109, 0, -7, -29, -145
"f:\Unity\Marbles Battle Royale (Chenli)\Marbles-Battle-Royale-Online-Game-Development\Marbles Battle Royale (Chenli)\Assets\Photon\PhotonUnityNetworking\Code\CustomTypes.cs", "C#", -48, 0, -13, -13, -74
"f:\Unity\Marbles Battle Royale (Chenli)\Marbles-Battle-Royale-Online-Game-Development\Marbles Battle Royale (Chenli)\Assets\Photon\PhotonUnityNetworking\Code\Editor\PhotonEditor.cs", "C#", -633, 0, -55, -167, -855
"f:\Unity\Marbles Battle Royale (Chenli)\Marbles-Battle-Royale-Online-Game-Development\Marbles Battle Royale (Chenli)\Assets\Photon\PhotonUnityNetworking\Code\Editor\PhotonGUI.cs", "C#", -273, 0, -11, -79, -363
"f:\Unity\Marbles Battle Royale (Chenli)\Marbles-Battle-Royale-Online-Game-Development\Marbles Battle Royale (Chenli)\Assets\Photon\PhotonUnityNetworking\Code\Editor\PhotonViewHandler.cs", "C#", -125, 0, -29, -37, -191
"f:\Unity\Marbles Battle Royale (Chenli)\Marbles-Battle-Royale-Online-Game-Development\Marbles Battle Royale (Chenli)\Assets\Photon\PhotonUnityNetworking\Code\Editor\PhotonViewInspector.cs", "C#", -277, 0, -42, -75, -394
"f:\Unity\Marbles Battle Royale (Chenli)\Marbles-Battle-Royale-Online-Game-Development\Marbles Battle Royale (Chenli)\Assets\Photon\PhotonUnityNetworking\Code\Editor\PunSceneSettings.cs", "C#", -131, 0, -16, -31, -178
"f:\Unity\Marbles Battle Royale (Chenli)\Marbles-Battle-Royale-Online-Game-Development\Marbles Battle Royale (Chenli)\Assets\Photon\PhotonUnityNetworking\Code\Editor\PunSceneSettingsInspector.cs", "C#", -186, 0, -18, -56, -260
"f:\Unity\Marbles Battle Royale (Chenli)\Marbles-Battle-Royale-Online-Game-Development\Marbles Battle Royale (Chenli)\Assets\Photon\PhotonUnityNetworking\Code\Editor\ReordableList\ReorderableListResources.cs", "C#", -134, 0, -71, -32, -237
"f:\Unity\Marbles Battle Royale (Chenli)\Marbles-Battle-Royale-Online-Game-Development\Marbles Battle Royale (Chenli)\Assets\Photon\PhotonUnityNetworking\Code\Editor\ServerSettingsInspector.cs", "C#", -233, 0, -15, -74, -322
"f:\Unity\Marbles Battle Royale (Chenli)\Marbles-Battle-Royale-Online-Game-Development\Marbles Battle Royale (Chenli)\Assets\Photon\PhotonUnityNetworking\Code\Editor\Views\MonoBehaviourPunEditor.cs", "C#", -23, 0, -9, -9, -41
"f:\Unity\Marbles Battle Royale (Chenli)\Marbles-Battle-Royale-Online-Game-Development\Marbles Battle Royale (Chenli)\Assets\Photon\PhotonUnityNetworking\Code\Editor\Views\PhotonAnimatorViewEditor.cs", "C#", -225, 0, -14, -56, -295
"f:\Unity\Marbles Battle Royale (Chenli)\Marbles-Battle-Royale-Online-Game-Development\Marbles Battle Royale (Chenli)\Assets\Photon\PhotonUnityNetworking\Code\Editor\Views\PhotonRigidbody2DViewEditor.cs", "C#", -31, 0, -9, -10, -50
"f:\Unity\Marbles Battle Royale (Chenli)\Marbles-Battle-Royale-Online-Game-Development\Marbles Battle Royale (Chenli)\Assets\Photon\PhotonUnityNetworking\Code\Editor\Views\PhotonRigidbodyViewEditor.cs", "C#", -31, 0, -9, -10, -50
"f:\Unity\Marbles Battle Royale (Chenli)\Marbles-Battle-Royale-Online-Game-Development\Marbles Battle Royale (Chenli)\Assets\Photon\PhotonUnityNetworking\Code\Editor\Views\PhotonTransformViewClassicEditor.cs", "C#", -297, 0, -34, -81, -412
"f:\Unity\Marbles Battle Royale (Chenli)\Marbles-Battle-Royale-Online-Game-Development\Marbles Battle Royale (Chenli)\Assets\Photon\PhotonUnityNetworking\Code\Editor\Views\PhotonTransformViewEditor.cs", "C#", -48, 0, -9, -15, -72
"f:\Unity\Marbles Battle Royale (Chenli)\Marbles-Battle-Royale-Online-Game-Development\Marbles Battle Royale (Chenli)\Assets\Photon\PhotonUnityNetworking\Code\Enums.cs", "C#", -27, 0, -49, -18, -94
"f:\Unity\Marbles Battle Royale (Chenli)\Marbles-Battle-Royale-Online-Game-Development\Marbles Battle Royale (Chenli)\Assets\Photon\PhotonUnityNetworking\Code\Interfaces\IPhotonViewCallbacks.cs", "C#", -19, 0, -26, -6, -51
"f:\Unity\Marbles Battle Royale (Chenli)\Marbles-Battle-Royale-Online-Game-Development\Marbles Battle Royale (Chenli)\Assets\Photon\PhotonUnityNetworking\Code\Interfaces\IPunCallbacks.cs", "C#", -24, 0, -107, -10, -141
"f:\Unity\Marbles Battle Royale (Chenli)\Marbles-Battle-Royale-Online-Game-Development\Marbles Battle Royale (Chenli)\Assets\Photon\PhotonUnityNetworking\Code\PhotonHandler.cs", "C#", -280, 0, -50, -71, -401
"f:\Unity\Marbles Battle Royale (Chenli)\Marbles-Battle-Royale-Online-Game-Development\Marbles Battle Royale (Chenli)\Assets\Photon\PhotonUnityNetworking\Code\PhotonNetwork.cs", "C#", -1693, 0, -1230, -390, -3313
"f:\Unity\Marbles Battle Royale (Chenli)\Marbles-Battle-Royale-Online-Game-Development\Marbles Battle Royale (Chenli)\Assets\Photon\PhotonUnityNetworking\Code\PhotonNetworkPart.cs", "C#", -1749, 0, -420, -391, -2560
"f:\Unity\Marbles Battle Royale (Chenli)\Marbles-Battle-Royale-Online-Game-Development\Marbles Battle Royale (Chenli)\Assets\Photon\PhotonUnityNetworking\Code\PhotonStreamQueue.cs", "C#", -113, 0, -52, -32, -197
"f:\Unity\Marbles Battle Royale (Chenli)\Marbles-Battle-Royale-Online-Game-Development\Marbles Battle Royale (Chenli)\Assets\Photon\PhotonUnityNetworking\Code\PhotonView.cs", "C#", -472, 0, -224, -130, -826
"f:\Unity\Marbles Battle Royale (Chenli)\Marbles-Battle-Royale-Online-Game-Development\Marbles Battle Royale (Chenli)\Assets\Photon\PhotonUnityNetworking\Code\PunClasses.cs", "C#", -521, 0, -348, -105, -974
"f:\Unity\Marbles Battle Royale (Chenli)\Marbles-Battle-Royale-Online-Game-Development\Marbles Battle Royale (Chenli)\Assets\Photon\PhotonUnityNetworking\Code\ServerSettings.cs", "C#", -62, 0, -23, -15, -100
"f:\Unity\Marbles Battle Royale (Chenli)\Marbles-Battle-Royale-Online-Game-Development\Marbles Battle Royale (Chenli)\Assets\Photon\PhotonUnityNetworking\Code\Utilities\NestedComponentUtilities.cs", "C#", -292, 0, -100, -102, -494
"f:\Unity\Marbles Battle Royale (Chenli)\Marbles-Battle-Royale-Online-Game-Development\Marbles Battle Royale (Chenli)\Assets\Photon\PhotonUnityNetworking\Code\Views\PhotonAnimatorView.cs", "C#", -408, 0, -68, -96, -572
"f:\Unity\Marbles Battle Royale (Chenli)\Marbles-Battle-Royale-Online-Game-Development\Marbles Battle Royale (Chenli)\Assets\Photon\PhotonUnityNetworking\Code\Views\PhotonRigidbody2DView.cs", "C#", -79, 0, -9, -23, -111
"f:\Unity\Marbles Battle Royale (Chenli)\Marbles-Battle-Royale-Online-Game-Development\Marbles Battle Royale (Chenli)\Assets\Photon\PhotonUnityNetworking\Code\Views\PhotonRigidbodyView.cs", "C#", -80, 0, -9, -23, -112
"f:\Unity\Marbles Battle Royale (Chenli)\Marbles-Battle-Royale-Online-Game-Development\Marbles Battle Royale (Chenli)\Assets\Photon\PhotonUnityNetworking\Code\Views\PhotonTransformView.cs", "C#", -155, 0, -12, -27, -194
"f:\Unity\Marbles Battle Royale (Chenli)\Marbles-Battle-Royale-Online-Game-Development\Marbles Battle Royale (Chenli)\Assets\Photon\PhotonUnityNetworking\Code\Views\PhotonTransformViewClassic.cs", "C#", -389, 0, -70, -98, -557
"f:\Unity\Marbles Battle Royale (Chenli)\Marbles-Battle-Royale-Online-Game-Development\Marbles Battle Royale (Chenli)\Assets\Photon\PhotonUnityNetworking\UtilityScripts\Culling\CullArea.cs", "C#", -281, 0, -144, -76, -501
"f:\Unity\Marbles Battle Royale (Chenli)\Marbles-Battle-Royale-Online-Game-Development\Marbles Battle Royale (Chenli)\Assets\Photon\PhotonUnityNetworking\UtilityScripts\Culling\CullingHandler.cs", "C#", -159, 0, -47, -48, -254
"f:\Unity\Marbles Battle Royale (Chenli)\Marbles-Battle-Royale-Online-Game-Development\Marbles Battle Royale (Chenli)\Assets\Photon\PhotonUnityNetworking\UtilityScripts\Culling\Editor\CullAreaEditor.cs", "C#", -183, 0, -25, -57, -265
"f:\Unity\Marbles Battle Royale (Chenli)\Marbles-Battle-Royale-Online-Game-Development\Marbles Battle Royale (Chenli)\Assets\Photon\PhotonUnityNetworking\UtilityScripts\Debugging\PhotonLagSimulationGui.cs", "C#", -67, 0, -21, -21, -109
"f:\Unity\Marbles Battle Royale (Chenli)\Marbles-Battle-Royale-Online-Game-Development\Marbles Battle Royale (Chenli)\Assets\Photon\PhotonUnityNetworking\UtilityScripts\Debugging\PhotonStatsGui.cs", "C#", -114, 0, -32, -24, -170
"f:\Unity\Marbles Battle Royale (Chenli)\Marbles-Battle-Royale-Online-Game-Development\Marbles Battle Royale (Chenli)\Assets\Photon\PhotonUnityNetworking\UtilityScripts\Debugging\PointedAtGameObjectInfo.cs", "C#", -56, 0, -12, -16, -84
"f:\Unity\Marbles Battle Royale (Chenli)\Marbles-Battle-Royale-Online-Game-Development\Marbles Battle Royale (Chenli)\Assets\Photon\PhotonUnityNetworking\UtilityScripts\Debugging\StatesGui.cs", "C#", -176, 0, -12, -24, -212
"f:\Unity\Marbles Battle Royale (Chenli)\Marbles-Battle-Royale-Online-Game-Development\Marbles Battle Royale (Chenli)\Assets\Photon\PhotonUnityNetworking\UtilityScripts\PhotonPlayer\Editor\PhotonTeamsManagerInspector.cs", "C#", -217, 0, -18, -11, -246
"f:\Unity\Marbles Battle Royale (Chenli)\Marbles-Battle-Royale-Online-Game-Development\Marbles Battle Royale (Chenli)\Assets\Photon\PhotonUnityNetworking\UtilityScripts\PhotonPlayer\Editor\PlayerNumberingInspector.cs", "C#", -43, 0, -13, -11, -67
"f:\Unity\Marbles Battle Royale (Chenli)\Marbles-Battle-Royale-Online-Game-Development\Marbles Battle Royale (Chenli)\Assets\Photon\PhotonUnityNetworking\UtilityScripts\PhotonPlayer\Editor\PunTeamsInspector.cs", "C#", -43, 0, -9, -13, -65
"f:\Unity\Marbles Battle Royale (Chenli)\Marbles-Battle-Royale-Online-Game-Development\Marbles Battle Royale (Chenli)\Assets\Photon\PhotonUnityNetworking\UtilityScripts\PhotonPlayer\PhotonTeamsManager.cs", "C#", -440, 0, -129, -59, -628
"f:\Unity\Marbles Battle Royale (Chenli)\Marbles-Battle-Royale-Online-Game-Development\Marbles Battle Royale (Chenli)\Assets\Photon\PhotonUnityNetworking\UtilityScripts\PhotonPlayer\PlayerNumbering.cs", "C#", -160, 0, -55, -52, -267
"f:\Unity\Marbles Battle Royale (Chenli)\Marbles-Battle-Royale-Online-Game-Development\Marbles Battle Royale (Chenli)\Assets\Photon\PhotonUnityNetworking\UtilityScripts\PhotonPlayer\PunPlayerScores.cs", "C#", -39, 0, -12, -11, -62
"f:\Unity\Marbles Battle Royale (Chenli)\Marbles-Battle-Royale-Online-Game-Development\Marbles Battle Royale (Chenli)\Assets\Photon\PhotonUnityNetworking\UtilityScripts\PhotonPlayer\PunTeams.cs", "C#", -98, 0, -35, -23, -156
"f:\Unity\Marbles Battle Royale (Chenli)\Marbles-Battle-Royale-Online-Game-Development\Marbles Battle Royale (Chenli)\Assets\Photon\PhotonUnityNetworking\UtilityScripts\PhotonView\SmoothSyncMovement.cs", "C#", -50, 0, -15, -7, -72
"f:\Unity\Marbles Battle Royale (Chenli)\Marbles-Battle-Royale-Online-Game-Development\Marbles Battle Royale (Chenli)\Assets\Photon\PhotonUnityNetworking\UtilityScripts\Prototyping\ConnectAndJoinRandom.cs", "C#", -53, 0, -53, -31, -137
"f:\Unity\Marbles Battle Royale (Chenli)\Marbles-Battle-Royale-Online-Game-Development\Marbles Battle Royale (Chenli)\Assets\Photon\PhotonUnityNetworking\UtilityScripts\Prototyping\MoveByKeys.cs", "C#", -64, 0, -33, -14, -111
"f:\Unity\Marbles Battle Royale (Chenli)\Marbles-Battle-Royale-Online-Game-Development\Marbles Battle Royale (Chenli)\Assets\Photon\PhotonUnityNetworking\UtilityScripts\Prototyping\OnClickDestroy.cs", "C#", -33, 0, -29, -10, -72
"f:\Unity\Marbles Battle Royale (Chenli)\Marbles-Battle-Royale-Online-Game-Development\Marbles Battle Royale (Chenli)\Assets\Photon\PhotonUnityNetworking\UtilityScripts\Prototyping\OnClickInstantiate.cs", "C#", -30, 0, -14, -12, -56
"f:\Unity\Marbles Battle Royale (Chenli)\Marbles-Battle-Royale-Online-Game-Development\Marbles Battle Royale (Chenli)\Assets\Photon\PhotonUnityNetworking\UtilityScripts\Prototyping\OnClickRpc.cs", "C#", -57, 0, -12, -20, -89
"f:\Unity\Marbles Battle Royale (Chenli)\Marbles-Battle-Royale-Online-Game-Development\Marbles Battle Royale (Chenli)\Assets\Photon\PhotonUnityNetworking\UtilityScripts\Prototyping\OnEscapeQuit.cs", "C#", -17, 0, -13, -2, -32
"f:\Unity\Marbles Battle Royale (Chenli)\Marbles-Battle-Royale-Online-Game-Development\Marbles Battle Royale (Chenli)\Assets\Photon\PhotonUnityNetworking\UtilityScripts\Prototyping\OnJoinedInstantiate.cs", "C#", -300, 0, -58, -93, -451
"f:\Unity\Marbles Battle Royale (Chenli)\Marbles-Battle-Royale-Online-Game-Development\Marbles Battle Royale (Chenli)\Assets\Photon\PhotonUnityNetworking\UtilityScripts\Prototyping\OnStartDelete.cs", "C#", -11, 0, -11, -2, -24
"f:\Unity\Marbles Battle Royale (Chenli)\Marbles-Battle-Royale-Online-Game-Development\Marbles Battle Royale (Chenli)\Assets\Photon\PhotonUnityNetworking\UtilityScripts\Room\CountdownTimer.cs", "C#", -101, 0, -33, -42, -176
"f:\Unity\Marbles Battle Royale (Chenli)\Marbles-Battle-Royale-Online-Game-Development\Marbles Battle Royale (Chenli)\Assets\Photon\PhotonUnityNetworking\UtilityScripts\TurnBased\PunTurnManager.cs", "C#", -206, 0, -146, -78, -430
"f:\Unity\Marbles Battle Royale (Chenli)\Marbles-Battle-Royale-Online-Game-Development\Marbles Battle Royale (Chenli)\Assets\Photon\PhotonUnityNetworking\UtilityScripts\UI\ButtonInsideScrollList.cs", "C#", -31, 0, -14, -8, -53
"f:\Unity\Marbles Battle Royale (Chenli)\Marbles-Battle-Royale-Online-Game-Development\Marbles Battle Royale (Chenli)\Assets\Photon\PhotonUnityNetworking\UtilityScripts\UI\EventSystemSpawner.cs", "C#", -23, 0, -13, -4, -40
"f:\Unity\Marbles Battle Royale (Chenli)\Marbles-Battle-Royale-Online-Game-Development\Marbles Battle Royale (Chenli)\Assets\Photon\PhotonUnityNetworking\UtilityScripts\UI\GraphicToggleIsOnTransition.cs", "C#", -41, 0, -11, -12, -64
"f:\Unity\Marbles Battle Royale (Chenli)\Marbles-Battle-Royale-Online-Game-Development\Marbles Battle Royale (Chenli)\Assets\Photon\PhotonUnityNetworking\UtilityScripts\UI\OnPointerOverTooltip.cs", "C#", -24, 0, -10, -11, -45
"f:\Unity\Marbles Battle Royale (Chenli)\Marbles-Battle-Royale-Online-Game-Development\Marbles Battle Royale (Chenli)\Assets\Photon\PhotonUnityNetworking\UtilityScripts\UI\TabViewManager.cs", "C#", -65, 0, -33, -25, -123
"f:\Unity\Marbles Battle Royale (Chenli)\Marbles-Battle-Royale-Online-Game-Development\Marbles Battle Royale (Chenli)\Assets\Photon\PhotonUnityNetworking\UtilityScripts\UI\TextButtonTransition.cs", "C#", -38, 0, -20, -12, -70
"f:\Unity\Marbles Battle Royale (Chenli)\Marbles-Battle-Royale-Online-Game-Development\Marbles Battle Royale (Chenli)\Assets\Photon\PhotonUnityNetworking\UtilityScripts\UI\TextToggleIsOnTransition.cs", "C#", -41, 0, -26, -19, -86
"f:\Unity\Marbles Battle Royale (Chenli)\Marbles-Battle-Royale-Online-Game-Development\Marbles Battle Royale (Chenli)\Assets\Photon\PhotonUnityNetworking\link.xml", "XML", 0, -14, 0, 0, -14
"f:\Unity\Marbles Battle Royale (Chenli)\Marbles-Battle-Royale-Online-Game-Development\Marbles Battle Royale (Chenli)\Assets\Scripts\AnimateLoading.cs", "C#", 22, 0, 4, 4, 30
"f:\Unity\Marbles Battle Royale (Chenli)\Marbles-Battle-Royale-Online-Game-Development\Marbles Battle Royale (Chenli)\Assets\Scripts\Billboard.cs", "C#", 46, 0, 3, 3, 52
"f:\Unity\Marbles Battle Royale (Chenli)\Marbles-Battle-Royale-Online-Game-Development\Marbles Battle Royale (Chenli)\Assets\Scripts\ButtonSoundCtrl.cs", "C#", 16, 0, 2, 5, 23
"f:\Unity\Marbles Battle Royale (Chenli)\Marbles-Battle-Royale-Online-Game-Development\Marbles Battle Royale (Chenli)\Assets\Scripts\CameraMove.cs", "C#", 55, 0, 2, 15, 72
"f:\Unity\Marbles Battle Royale (Chenli)\Marbles-Battle-Royale-Online-Game-Development\Marbles Battle Royale (Chenli)\Assets\Scripts\CollisionDetect.cs", "C#", 219, 0, 93, 43, 355
"f:\Unity\Marbles Battle Royale (Chenli)\Marbles-Battle-Royale-Online-Game-Development\Marbles Battle Royale (Chenli)\Assets\Scripts\CollisionTrigger.cs", "C#", 36, 0, 41, 17, 94
"f:\Unity\Marbles Battle Royale (Chenli)\Marbles-Battle-Royale-Online-Game-Development\Marbles Battle Royale (Chenli)\Assets\Scripts\GameInfoItem.cs", "C#", 32, 0, 1, 3, 36
"f:\Unity\Marbles Battle Royale (Chenli)\Marbles-Battle-Royale-Online-Game-Development\Marbles Battle Royale (Chenli)\Assets\Scripts\GameInfoManager.cs", "C#", 27, 0, 15, 4, 46
"f:\Unity\Marbles Battle Royale (Chenli)\Marbles-Battle-Royale-Online-Game-Development\Marbles Battle Royale (Chenli)\Assets\Scripts\GameSetting.cs", "C#", 22, 0, 3, 3, 28
"f:\Unity\Marbles Battle Royale (Chenli)\Marbles-Battle-Royale-Online-Game-Development\Marbles Battle Royale (Chenli)\Assets\Scripts\InGameUIManager.cs", "C#", 74, 0, 14, 7, 95
"f:\Unity\Marbles Battle Royale (Chenli)\Marbles-Battle-Royale-Online-Game-Development\Marbles Battle Royale (Chenli)\Assets\Scripts\JumpController.cs", "C#", 118, 0, 25, 22, 165
"f:\Unity\Marbles Battle Royale (Chenli)\Marbles-Battle-Royale-Online-Game-Development\Marbles Battle Royale (Chenli)\Assets\Scripts\JumpPad.cs", "C#", 14, 0, 0, 2, 16
"f:\Unity\Marbles Battle Royale (Chenli)\Marbles-Battle-Royale-Online-Game-Development\Marbles Battle Royale (Chenli)\Assets\Scripts\Keep.cs", "C#", 51, 0, 16, 15, 82
"f:\Unity\Marbles Battle Royale (Chenli)\Marbles-Battle-Royale-Online-Game-Development\Marbles Battle Royale (Chenli)\Assets\Scripts\LeftandRight.cs", "C#", 53, 0, 15, 15, 83
"f:\Unity\Marbles Battle Royale (Chenli)\Marbles-Battle-Royale-Online-Game-Development\Marbles Battle Royale (Chenli)\Assets\Scripts\Menu Scrips\Menu.cs", "C#", 24, 0, 1, 7, 32
"f:\Unity\Marbles Battle Royale (Chenli)\Marbles-Battle-Royale-Online-Game-Development\Marbles Battle Royale (Chenli)\Assets\Scripts\Menu Scrips\MenuManager.cs", "C#", 91, 0, 17, 13, 121
"f:\Unity\Marbles Battle Royale (Chenli)\Marbles-Battle-Royale-Online-Game-Development\Marbles Battle Royale (Chenli)\Assets\Scripts\Menu Scrips\NetworkManager.cs", "C#", 250, 0, 32, 44, 326
"f:\Unity\Marbles Battle Royale (Chenli)\Marbles-Battle-Royale-Online-Game-Development\Marbles Battle Royale (Chenli)\Assets\Scripts\Menu Scrips\PlayerListItem.cs", "C#", 24, 0, 4, 6, 34
"f:\Unity\Marbles Battle Royale (Chenli)\Marbles-Battle-Royale-Online-Game-Development\Marbles Battle Royale (Chenli)\Assets\Scripts\Menu Scrips\PlayerManager.cs", "C#", 256, 0, 47, 39, 342
"f:\Unity\Marbles Battle Royale (Chenli)\Marbles-Battle-Royale-Online-Game-Development\Marbles Battle Royale (Chenli)\Assets\Scripts\Menu Scrips\RoomListItem.cs", "C#", 19, 0, 0, 6, 25
"f:\Unity\Marbles Battle Royale (Chenli)\Marbles-Battle-Royale-Online-Game-Development\Marbles Battle Royale (Chenli)\Assets\Scripts\Menu Scrips\RoomManager.cs", "C#", 56, 0, 7, 15, 78
"f:\Unity\Marbles Battle Royale (Chenli)\Marbles-Battle-Royale-Online-Game-Development\Marbles Battle Royale (Chenli)\Assets\Scripts\Menu Scrips\RotateAndShake.cs", "C#", 66, 0, 4, 16, 86
"f:\Unity\Marbles Battle Royale (Chenli)\Marbles-Battle-Royale-Online-Game-Development\Marbles Battle Royale (Chenli)\Assets\Scripts\MovementController.cs", "C#", 163, 0, 20, 20, 203
"f:\Unity\Marbles Battle Royale (Chenli)\Marbles-Battle-Royale-Online-Game-Development\Marbles Battle Royale (Chenli)\Assets\Scripts\ParticleFollow.cs", "C#", 47, 0, 15, 9, 71
"f:\Unity\Marbles Battle Royale (Chenli)\Marbles-Battle-Royale-Online-Game-Development\Marbles Battle Royale (Chenli)\Assets\Scripts\ScoreBoard.cs", "C#", 66, 0, 3, 8, 77
"f:\Unity\Marbles Battle Royale (Chenli)\Marbles-Battle-Royale-Online-Game-Development\Marbles Battle Royale (Chenli)\Assets\Scripts\ScoreBoardManager.cs", "C#", 61, 0, 37, 13, 111
"f:\Unity\Marbles Battle Royale (Chenli)\Marbles-Battle-Royale-Online-Game-Development\Marbles Battle Royale (Chenli)\Assets\Scripts\SoundController.cs", "C#", 25, 0, 6, 6, 37
"f:\Unity\Marbles Battle Royale (Chenli)\Marbles-Battle-Royale-Online-Game-Development\Marbles Battle Royale (Chenli)\Assets\Scripts\SpectatorMovement.cs", "C#", 84, 0, 12, 12, 108
"f:\Unity\Marbles Battle Royale (Chenli)\Marbles-Battle-Royale-Online-Game-Development\Marbles Battle Royale (Chenli)\Assets\Scripts\TouchUp.cs", "C#", 44, 0, 30, 15, 89
"f:\Unity\Marbles Battle Royale (Chenli)\Marbles-Battle-Royale-Online-Game-Development\Marbles Battle Royale (Chenli)\Assets\Scripts\WallFoward.cs", "C#", 18, 0, 1, 5, 24
"f:\Unity\Marbles Battle Royale (Chenli)\Marbles-Battle-Royale-Online-Game-Development\Marbles Battle Royale (Chenli)\Assets\Scripts\cameraDist.cs", "C#", 69, 0, 12, 8, 89
"f:\Unity\Marbles Battle Royale (Chenli)\Marbles-Battle-Royale-Online-Game-Development\Marbles Battle Royale (Chenli)\Assets\Scripts\getspeed.cs", "C#", 23, 0, 4, 7, 34
"f:\Unity\Marbles Battle Royale (Chenli)\Marbles-Battle-Royale-Online-Game-Development\Marbles Battle Royale (Chenli)\Assets\Scripts\maincamera.cs", "C#", 124, 0, 13, 24, 161
"Total", "-", -17466, -14, -10247, -4598, -32325